111111111111111111111111111111111111111111111111111111111111
10000001E100000C00000C0000000000010000C0000S00000C0000000001
10100100101000001010010000S001010101001010100101010111001011
10100100101000100010010000ES0100010000C0001000C0000001000001
1P0000000C00C000S000000000S00000C1001010100000000C00010S0001
101111011111111111110111111111110100000111111111101111011101
100000000000000C00000000000000000001010000000000000000000001
101011111110111111111111101111111111011111111011111111110101
10100000000000000C000000000000000000000000000000000000000101
101111011111111111111111101111111111111111111011111111111101
1000000000C00000000000000000000S0000000C00000000000000000001
111101111111111110111111111111111111111111011111111111011111
100000000000000000000000000000C00000000000000000000000000001
101111011111111111111111101111111111111111111011111111111101
1010000000000000C0000000000000000000000000000000000000000101
101011111110111111111111101111111111111111111011111111110101
100000000000000C00000000000000000001010000000000000000000001
101111011111111111111111101111111111111111111011111111111101
1000000000C00000000000000000000S0000000C00000000000000000001
111101111111111110111111111111111111111111011111111111011111
100000000000000000000000000000C00000000000000000000000000001
101111011111111111111111101111111111111111111011111111111101
1010000000000000C0000000000000000000000000000000000000000101
101011111110111111111111101111111111111111111011111111110101
100000000000000C00000000000000000001010000000000000000000001
101111011111111111111111101111111111111111111011111111111101
1000000000C00000000000000000000S0000000C00000000000000000001
111101111111111110111111111111111111111111011111111111011111
100000000000000000000000000000C00000000000000000000000000001
100000000000C0000000S000000000S00000C1001010100000000C000001
1010010000100010001001000000010000010000C0001000C00000010001
10000001E100000C00000C0000000000010000C0000S00000C0000000001
111111111111111111111111111111111111111111111111111111111111