11111111111111111111111111111111111111111111111111111111111111111111111111111111
100000010100000C00000C00000000000100000010100000C00000C00000000000100000C0000001
10100100101000001010010000S00101010100100101000001010010000S00101010010101011001
101001001010001000100100000S01000101001001010001000100100000S010001000C000000001
1P0000000C00C000S000000000S00000C10000000C00C000S000000000S00000C100000000C00001
10111101111111111111011111111111011111011111111111110111111111110101111111111101
100000000000000C0000000000000000000000000000000C00000000000000000000000000000001
10101111111011111111111110111111111111111111111111111011111111111111111111110101
10100000000000000C000000000000000000000000000000C0000000000000000000000000000101
10111101111111111111111110111111111111111111111111111011111111111111111111111101
1000000000C00000000000000000000S0000000C00000000000000000000000S0000000C00000001
11110111111111111011111111111111111111111111111111111111111111111111111111011111
100000000000000000000000000000C0000000000000000000000000000000C00000000000000001
10111101111111111111111110111111111111111111111111111011111111111111111111111101
1010000000000000C0000000000000000000000000000000C0000000000000000000000000000101
10101111111011111111111110111111111111111111111111111011111111111111111111110101
100000000000000C0000000000000000000101000000000000000000000000000000000000000001
10111101111111111111111110111111111111111111111111111011111111111111111111111101
1000000000C00000000000000000000S0000000C00000000000000000000000S0000000C00000001
11110111111111111011111111111111111111111111111111111111111111111111111111011111
100000000000000000000000000000C0000000000000000000000000000000C00000000000000001
10111101111111111111111110111111111111111111111111111011111111111111111111111101
1010000000000000C0000000000000000000000000000000C0000000000000000000000000000101
10101111111011111111111110111111111111111111111111111011111111111111111111110101
100000000000000C0000000000000000000101000000000000000000000000000000000000000001
10111101111111111111111110111111111111111111111111111011111111111111111111111101
1000000000C00000000000000000000S0000000C00000000000000000000000S0000000C00000001
11110111111111111011111111111111111111111111111111111111111111111111111111011111
100000000000000000000000000000C0000000000000000000000000000000C00000000000000001
10111101111111111111111110111111111111111111111111111011111111111111111111111101
1010000000000000C0000000000000000000000000000000C0000000000000000000000000000101
10101111111011111111111110111111111111111111111111111011111111111111111111110101
100000000000000C0000000000000000000101000000000000000000000000000000000000000001
10111101111111111111111110111111111111111111111111111011111111111111111111111101
1000000000C00000000000000000000S0000000C00000000000000000000000S0000000C00000001
11110111111111111011111111111111111111111111111111111111111111111111111111011111
100000000000000000000000000000C0000000000000000000000000000000C00000000000000001
10111101111111111111111110111111111111111111111111111011111111111111111111111101
1010000000000000C0000000000000000000000000000000C0000000000000000000000000000101
10111101111111111111111110111111111111111111111111111011111111111111111111111101
1000000000C00000000000000000000S0000000C000000E0000000000000000S0000000C00000001
100000010100000C00000C00000000000100000010100000C00000C00000000000100000C0000001
11111111111111111111111111111111111111111111111111111111111111111111111111111111