1111111111111111111111111111111111
10000000E000000C00000C000000000001
1010010100100000101001000C00010101
101001001010101000100100CE00010101
1P0000000C00C0000000000000000000C1
1111111111111111111111111111111111
