1111111111111111111111111111111111
100000010100000C00000C000000000001
10100100000000001010010000S0010101
1010100001000100010010000ES0100001
1P1000001C00C0000000000000S00000C1
1111111111111111111111111111111111
