1111111111111111111111111111111111
100000010100000C00000C000000000001
1010010000000000101001000000010101
1010100001000100010010000E00100001
1P1000001C00C0000000000000S00000C1
1111111111111111111111111111111111
