11111111111111
100E000C0C00P1
11111111111011