1111111111111111111111111111111111
10000001E100000C00000C000000000001
10100100101000001010010000S0010101
10100100101000100010010000ES010001
1P0000000C00C000S000000000S00000C1
1111111111111111111111111111111111
