11111111111111
1000E00C0S00P1
11111111111111